#########
#   #####
#r#  # ##
### ##  #
#   #   #
# ### # #
#     # #
####### #
#       #
# #### ##
#  Q## ##
#########