#####################
######             ##
# r  # ## ######## ##
#### #### ##       ##
####      ##   ######
#### ####          ##
####  ###############
##### ####          #
#     #### ######## #
##### #### ###### # #
##### ####      # # #
###   #### #### # # #
### #      #### # # #
### ###### #### #   #
###            ######
####### ######    ###
###     ###### ## ###
#   # #     ##  # ###
### # ##### ## ## ###
#Q  # #     ##  #   #
#####################